آداب	ادب
اطراف	طرف
حقایق	حقیقت
امواج	موج
ادبا	ادیب
اعماق	عمق
خزائن	خزینه
مراکز	مرکز
آثار	اثر
علما	عالم
اخبار	خبر
مواقع	موقع
اسرا	سر
علوم	علم
ادوار	دور
مصارف	مصرف
اسامی	اسم
علائم	علامت
ادیان	دین
معارف	معرفت
اساطیر	اسطوره
علل		علت
دفاتر	دفتر
مباحث	مبحث
امرا	امیر
عقائد	عقیده
ذخایر	ذخیره
مواد	ماده
اوامر	امور
اعمال	عمل
رفقا	رفیق
مذاهب	مذهب
ائمه	امام
اعیاد	عید
آرا		رای
مصائب	مصیبت
اصول	اصل
عناصر	عنصر
رسوم	رسم
معابد	معبد
آفاق	افق
عواطف	عاطفه
روابط	رابطه
مساجد	مسجد
ابیات	بیت
اعضا	عضو
رموز	رمز
معابر	معبر
تجار		تاجر
عبارات	عبارت
رجال	رجل
مظاهر	مظهر
تصاویر	تصویر
عجایب	عجیبه
ارقام	رقم
اجداد	جد
فقها	فقیه
زوایا	زاویه
امراض	مرض
جوانب	جانب
فنون	فن
زعما	زعیم
موارد	موزد
جزایر	جزیره
افکار	فکر
سوانح	سانحه
مراحل	مرحله
جبال	جبل
فرایض	فریضه
سلاطین	سلطان
مفاهیم	مفهوم
جرایم	جریمه
افعال	فعل
اشعار	شعر
منابع	منبع
حوادث	حادثه
فقرا	فقیر
شعرا	شاعر
اماکن	مکان
احشام	حشم
قواعد	قاعده
آثار	اثر
احوال 	حال
اخلاق 	خلق
ارکان 	رکن
اسرار 	سر
اشیا 	شی
اصول 	اصل
اعضا 	عضو
افراد  	فرد
افکار 	فکر
اقوام	قوم
اوقات 	وقت
تصاویر 	تصویر
تعالیم 	تعلیم
تماثیل 	تمثیل
حقوق 	حق
حواس 	حس
خاطرات 	خاطره
خرافات	خارفه
دلایل 	دلیل
شمایل 	شمیله
عناصر 	عنصر
عوامل	عامل
فضایل 	فضیلت
کلمات  	کلمه
مجالس 	مجلس
مطالب 	مطلب
مظاهر  	مظهره
مفاهیم 	مفهوم
منابع 	منبع
نشریات	نشریه
نیّات  	نیت
وظایف 	وظیفه
فلاسفه	فلاس
مذاکرات	مذاکره
معاملات	معامله
ادارات	اداره
ضربات	ضربه
حملات	حمله
جزِئیات	جزء
دخانیات	دخان
شایعات	شایعه
عنایات	عنایت
اموال	مال
مدارس مدرسه
جوامع جامعه
